000000000000000000000000
091111011100010000000000
016111100100010000011100
010111000111010000010000
000110100011010111111100
000110100001011100000000
001111100001000100000000
000110000001000111111110
011111111111111110010000
000000100000001010010000
000000100000111011110110
000001111111111110000100
000001000000000010000100
001111000000011111111118
011000000000110000000000
001111111111110000000000
000000000000000000000000