11111111111111
10000000000101
10110010010001
10100001000101
10110011010001
11100001101011
10010100010001
10000001000101
10100100001001
10000100110001
11111111111111

