11111111111111
10000100000101
10010010010001
11000001000101
10001000101001
10100001001011
10010100000001
10100001010011
10011000001001
10000000010001
11111111111111

