01111111110
01000100010
01003000010
01030333011
01000200001
11001110301
10440400001
10440443011
11111111110
