00000000
00111000
00101110
01211110
01113100
00010400
00011100
00000000