00000000
00111000
00301110
01111410
01121100
00010100
00000000