00000000
00411100
00101110
01111110
00121100
00030100
00011100
00000000